5 5 5 63 64 5 5 63 50 51 50 51 50 51 64 48 49 5 20 63 50 51 50 51 64 63 64 63 64 5 36 5 63 50 51 50 65 50 51 64 63 64 5 45 46 5 30 31 63 50
48 49 5 5 5 5 5 48 51 50 51 50 51 50 49 63 64 35 5 48 65 50 51 50 49 5 5 5 36 5 5 5 5 63 50 65 50 51 50 49 5 5 5 5 5 5 45 46 5 63
63 50 49 5 48 49 5 63 50 51 50 51 50 51 64 5 5 36 5 63 50 51 50 51 64 20 5 35 5 5 5 20 5 35 63 50 65 50 65 64 35 5 5 5 5 5 5 5 20 5
5 63 64 48 51 50 49 5 63 50 51 50 51 50 49 20 5 5 5 5 63 64 63 50 49 20 20 5 5 36 5 5 5 20 48 65 50 65 50 49 5 35 48 49 20 5 36 5 5 5
90 91 5 63 50 51 64 5 5 63 50 51 50 51 64 5 36 5 5 35 5 35 5 63 50 49 48 49 48 49 5 5 36 5 63 50 65 50 65 50 49 48 65 50 49 5 5 35 5 5
105 106 5 5 63 64 5 5 60 61 63 64 63 50 49 5 20 5 5 36 5 5 20 5 63 50 51 50 51 50 49 20 5 5 5 63 64 63 64 63 50 51 66 51 50 49 5 5 5 5
5 2 3 3 3 3 3 4 75 76 48 49 48 51 50 49 5 35 5 5 5 36 5 5 5 63 50 51 50 51 66 49 5 5 5 5 20 5 35 5 63 50 51 50 51 50 49 5 5 36
5 17 6 6 6 6 6 19 5 48 51 50 51 50 51 50 49 5 36 5 5 5 5 35 20 48 51 50 51 50 51 64 5 5 36 5 36 5 5 5 48 51 50 51 50 51 64 5 5 5
5 17 6 6 6 6 6 19 5 63 50 51 50 51 50 51 50 49 5 5 20 5 36 5 20 63 50 51 50 51 64 35 5 5 5 5 5 5 20 48 65 50 51 50 51 64 20 5 5 5
49 17 6 6 6 6 6 19 36 48 51 50 51 50 51 50 51 64 30 31 5 5 5 5 5 48 65 50 65 64 5 5 5 35 5 5 20 5 48 51 50 51 66 65 50 49 20 5 5 5
64 32 33 33 1 6 6 19 5 63 50 51 50 51 50 51 50 49 45 46 35 36 5 36 5 63 64 63 64 20 20 5 5 36 5 48 49 48 51 50 51 50 51 50 51 50 49 5 36 35
5 5 5 5 17 6 6 19 36 5 63 50 51 50 51 50 51 50 49 48 49 5 5 5 5 5 5 5 5 5 5 5 5 5 48 51 50 51 50 51 50 51 50 51 50 51 64 5 5 5
90 91 48 49 17 6 6 19 5 5 48 51 50 51 50 51 50 51 50 51 50 49 20 5 5 5 35 5 36 5 5 5 36 5 63 64 63 64 63 64 63 64 63 64 63 64 5 5 5 5
105 106 63 64 17 6 6 19 5 48 51 50 51 50 51 50 51 50 51 50 51 50 49 20 36 5 5 5 5 20 5 5 5 5 5 5 5 5 5 36 5 20 5 5 5 5 36 5 20 5
36 5 5 5 17 6 6 19 48 51 64 63 50 51 50 51 50 51 50 51 50 51 50 49 48 49 48 49 48 49 20 5 5 5 5 35 5 5 5 5 5 5 5 5 35 5 5 20 20 48
5 48 49 5 17 6 6 19 63 64 5 48 51 50 51 50 51 50 51 50 51 50 51 50 51 50 51 50 65 66 49 5 5 36 5 5 5 20 48 49 48 49 48 49 48 49 48 49 48 51
5 63 64 5 17 6 6 19 5 5 5 63 50 51 50 51 50 51 50 51 50 51 50 51 50 51 50 51 50 51 64 5 35 5 5 48 49 48 51 50 51 50 51 50 51 50 51 50 51 50
36 5 5 36 17 6 6 19 36 5 5 5 63 50 51 50 51 50 51 50 51 50 51 50 51 50 51 50 65 50 49 5 5 5 48 51 50 51 64 63 64 63 64 63 66 65 64 63 64 63
5 5 5 5 17 6 6 15 4 5 5 36 5 63 50 51 50 51 50 51 64 63 64 63 50 51 64 63 50 51 64 5 5 5 63 50 51 64 5 5 5 5 5 5 63 64 5 5 5 5
5 36 5 5 32 1 6 6 19 5 60 61 5 5 63 64 63 64 63 64 5 5 5 36 63 64 5 5 63 64 5 5 5 5 5 63 64 5 5 5 5 5 5 5 5 5 5 5 5 5
5 5 5 36 5 17 6 6 19 5 75 76 5 5 36 5 5 5 5 21 5 5 5 5 5 5 5 5 5 5 2 3 3 4 20 5 5 36 5 5 5 20 5 5 36 5 5 36 5 5
5 5 5 60 61 17 6 6 19 5 5 5 5 5 5 5 5 5 5 5 5 5 5 5 5 5 5 5 5 5 17 18 18 19 5 5 5 5 5 5 5 5 5 35 5 5 5 5 20 5
5 36 5 75 76 17 6 6 19 5 36 5 21 5 90 91 5 36 5 5 5 36 5 5 5 21 5 5 36 5 17 18 18 19 5 5 5 5 35 5 36 5 5 5 20 5 5 5 5 5
5 5 5 36 5 17 6 6 19 5 5 5 5 5 105 106 5 5 5 5 5 5 5 5 5 5 5 5 5 5 17 18 18 19 5 36 5 5 5 5 5 36 5 5 5 36 5 5 36 5
5 36 5 5 5 17 6 6 15 4 5 5 5 5 5 5 5 5 5 5 5 5 5 36 5 5 5 5 5 5 17 18 18 19 5 5 20 36 5 5 5 5 5 5 5 5 5 5 5 5
5 5 5 36 5 17 6 6 6 19 5 5 5 36 5 5 5 5 21 5 90 91 5 5 5 5 21 5 5 5 17 18 18 19 5 5 5 5 5 5 5 20 5 35 5 36 5 5 5 5
5 60 61 5 5 32 1 6 6 19 5 60 61 5 5 36 5 5 5 5 105 106 5 36 5 5 5 5 5 36 17 18 18 19 5 5 5 35 5 5 36 5 5 5 5 5 20 5 36 5
5 75 76 5 5 5 17 6 6 19 5 75 76 5 5 5 5 5 5 5 5 5 5 5 5 5 5 60 61 5 17 18 18 19 5 36 5 5 5 5 20 5 5 5 5 5 5 5 5 5
5 36 5 5 5 36 17 6 6 19 5 36 5 5 21 5 5 5 36 5 5 5 5 21 5 5 5 75 76 5 17 18 18 19 5 5 5 5 36 5 5 5 5 5 36 5 36 5 35 5
5 5 5 36 5 5 17 6 6 19 27 27 27 27 27 27 27 27 27 27 27 27 27 27 27 36 27 27 27 27 17 18 18 19 5 5 35 5 5 5 5 5 35 36 5 5 5 5 5 5
5 5 5 5 36 5 17 6 6 15 3 3 3 3 3 3 3 3 3 3 3 3 3 3 3 3 3 3 3 3 16 18 18 19 5 36 5 5 5 5 5 36 5 5 5 5 5 20 36 5
36 5 5 5 5 5 17 6 6 6 6 6 6 6 6 6 6 6 6 6 6 6 6 6 6 6 6 6 6 6 6 18 18 19 5 5 5 5 36 20 5 5 5 5 36 5 5 5 5 5
2 3 3 3 3 3 16 6 6 6 0 33 33 33 33 33 33 33 33 33 33 33 33 33 33 33 33 33 33 33 33 1 18 15 3 3 3 3 3 3 3 3 3 3 3 3 3 3 4 36
17 6 6 6 6 6 6 6 6 6 19 11 42 42 42 42 42 42 42 42 42 42 42 42 42 42 42 42 42 42 13 17 18 18 18 18 18 18 18 18 18 18 18 18 18 18 18 18 19 5
32 33 33 33 33 33 33 1 6 6 19 26 5 5 5 36 5 5 35 5 5 21 5 5 5 5 5 5 5 5 14 17 18 18 18 18 18 18 18 18 18 18 18 18 18 18 18 18 19 5
42 42 42 42 42 42 13 17 6 6 19 26 5 35 5 5 21 5 5 35 5 5 36 5 21 35 5 5 21 5 14 17 18 0 33 33 33 33 33 33 33 33 33 33 33 33 33 33 34 5
53 54 55 53 54 55 73 17 6 6 19 26 21 5 47 5 36 5 5 5 5 5 5 5 5 5 5 47 5 35 14 17 18 19 11 42 42 42 42 42 42 42 42 42 42 42 42 42 13 36
53 54 55 53 54 55 73 17 6 6 19 26 5 36 5 5 35 5 21 5 36 5 21 5 35 5 21 5 5 5 14 17 6 19 26 5 5 5 5 5 5 5 5 5 5 27 5 5 28 5
53 54 55 53 54 55 73 17 6 6 19 120 121 122 123 124 125 126 127 128 129 130 5 5 5 5 5 35 21 5 5 17 6 19 26 5 36 5 5 5 5 36 5 5 36 5 5 5 28 5
53 54 55 53 54 55 73 17 6 6 19 135 136 137 138 139 140 141 142 143 144 145 5 5 36 5 5 5 5 5 5 17 6 19 26 5 5 5 5 36 27 5 5 5 5 5 5 36 28 36
53 54 55 53 54 55 73 17 6 6 19 150 151 152 153 154 155 156 157 158 159 160 5 5 5 5 5 5 5 5 5 17 6 19 26 5 5 36 5 5 27 36 5 36 5 5 5 5 28 5
53 54 55 53 54 55 73 17 6 6 19 165 166 167 168 169 170 171 172 173 5 5 5 5 5 5 5 5 5 5 28 17 6 19 26 36 5 5 5 5 36 5 5 5 36 5 36 5 28 5
53 54 55 53 54 55 73 17 6 6 19 180 184 184 184 184 184 184 184 188 5 21 36 5 5 35 5 36 5 21 28 17 6 19 26 5 5 5 36 5 27 5 5 5 5 5 5 5 28 5
53 54 55 53 54 55 73 17 6 6 19 180 181 181 181 181 181 181 181 188 5 36 5 5 36 5 5 5 5 5 28 17 6 19 26 5 36 5 5 5 27 5 36 5 5 5 36 5 28 36
53 54 55 53 54 55 73 17 6 6 19 180 181 181 181 181 181 181 181 188 5 5 5 35 5 21 5 36 35 5 28 17 6 19 26 5 5 5 5 5 36 5 5 5 36 5 5 5 28 5
53 54 55 53 54 55 73 17 6 6 19 195 196 197 198 199 200 201 202 203 42 42 42 42 42 42 42 42 42 42 43 17 6 19 41 42 42 42 42 42 42 42 42 42 42 42 42 42 43 5
87 87 87 87 87 87 88 17 6 6 15 3 3 3 3 3 3 3 3 3 3 3 3 3 3 3 3 3 3 3 3 16 6 15 3 3 3 3 3 3 3 3 3 3 3 3 3 3 4 36
3 3 3 3 3 3 3 16 6 6 6 6 6 6 6 6 6 6 6 6 6 6 6 6 6 6 6 6 6 6 6 6 6 6 6 6 6 6 6 6 6 6 6 6 6 6 6 6 19 5
6 6 6 6 6 6 6 6 6 6 0 33 33 33 33 33 33 33 33 33 33 33 33 33 33 33 33 33 33 33 33 33 33 33 33 33 33 33 33 33 33 33 33 33 33 33 33 33 34 5
33 33 33 33 33 33 33 33 33 33 34 36 5 5 5 5 36 5 5 36 5 5 5 36 5 5 5 36 5 5 5 5 36 5 5 5 5 36 5 5 5 5 36 5 5 5 36 5 5 36